new	mới
company	công ty
year	năm
service	dịch vụ
please	vui lòng
customer	khách hàng
work	làm việc / công việc
email	thư điện tử
make	làm
more	thêm / nhiều hơn
time	thời gian / thời điểm
product	sản phẩm
business	kinh doanh / doanh nghiệp
day	ngày
employee	nhân viên
use	sử dụng
information	thông tin
member	thành viên
order	đơn hàng / đặt hàng
letter	lá thư
provide	cung cấp
date	ngày
receive	nhận
office	văn phòng
manage	quản lý
month	tháng
most	nhiều nhất / hầu hết
also	cũng
hotel	khách sạn
include	bao gồm
than	so với
only	chỉ
price	giá
purchase	mua
other	khác
week	tuần
thank	cám ơn
send	gửi
plan	kế hoạch / lên kế hoạch
open	mở
contact	liên lạc
change	thay đổi
add	thêm
store	cửa hàng
article	bài báo
call	gọi
schedule	lịch trình / lên lịch
event	sự kiện
first	đầu tiên / thứ nhất
center	trung tâm
free	miễn phí / tự do
ask	hỏi / yêu cầu
like	thích
next	tiếp theo
request	yêu cầu
job	việc làm / công việc
before	trước
department	bộ phận
after	sau
design	thiết kế
city	thành phố
number	số / số lượng
high	cao
need	cần
conference	hội nghị
know	biết
meeting	cuộc họp
give	đưa / đưa ra
special	đặc biệt
staff	nhân viên
room	phòng
announce	thông báo
website	trang web
write	viết
visit	ghé thăm / chuyến đi
hour	giờ
require	yêu cầu
help	giúp đỡ
because	bởi vì
increase	tăng
people	người
find	tìm thấy / cảm thấy
complete	hoàn thành / hoàn chỉnh
attend	tham dự
program	chương trình
book	sách
according to	theo như
many	nhiều
food	đồ ăn / thực phẩm
travel	đi lại / du lịch
last	vừa qua / trước
current	hiện tại
project	dự án
report	báo cáo
form	mẫu (đơn)
follow	theo sau / làm theo
area	khu vực
during	trong suốt
experience	kinh nghiệm
notice	chú ý / thông báo
team	đội / nhóm
pay	chi trả
cost (n)	chi phí
march	tháng Ba
computer	máy tính
come	đến
very	rất
june	tháng Sáu
see	xem / thấy
problem	vấn đề
deliver	giao (hàng...)
each	mỗi
want	muốn
start	bắt đầu
submit	nộp
large	lớn
home	nhà
say	nói
hope	hy vọng
there is	có
where	nơi nào / nơi mà
card	thẻ
register	đăng ký
expect	trông đợi
able	có thể
best	tốt nhất
ticket	vé
develop	phát triển
now	bây giờ
august	tháng Tám
director	giám đốc
april	tháng Tư
get	có được / lấy
name	tên
question	câu hỏi
july	tháng Bảy
much	nhiều
take	lấy / mang
ship	giao (hàng)
begin	bắt đầu
research	nghiên cứu
advertise	quảng cáo
charge	phí / tính phí
long	dài / lâu
return	trả lại / trở lại
hold	tổ chức
while	trong khi
review	xem lại / đánh giá
every	mỗi
mention	đề cập
system	hệ thống
class	lớp học
into	vào trong
training	đào tạo / huấn luyện
group	nhóm
restaurant	nhà hàng
health	sức khỏe
full	đầy đủ / toàn bộ
main	chính / chủ yếu
part	phần
read	đọc
construction	xây dựng
international	quốc tế
success	sự thành công
contract	hợp đồng
fee	khoản phí
quality	chất lượng
client	khách hàng
university	trường đại học
close	gần / gần gũi
within	trong vòng
repair	sửa chữa
september	tháng Chín
end	kết thúc / cuối
participate	tham gia
interview	buổi phỏng vấn
building	tòa nhà
however	tuy nhiên
student	sinh viên
list	danh sách / liệt kê
publish	xuất bản
result	kết quả
arrive	đến
both	cả hai
confirm	xác nhận
until	cho đến khi
inform	thông báo cho
technology	công nghệ
monday	thứ Hai
discuss	bàn bạc / thảo luận
just	chỉ / vừa mới
october	tháng Mười
good	tốt
car	xe hơi
let	cho / để
street	đường
hire	thuê
copy	bản sao / sao chép
few	ít / vài
important	quan trọng
small	nhỏ
magazine	tạp chí
art	nghệ thuật
address	địa chỉ
sell	bán
consider	xem xét
meet	gặp
water	nước
world	thế giới
apply	nộp đơn xin
equipment	thiết bị
trip	chuyến đi
account	tài khoản
great	tuyệt vời / rất lớn
opportunity	cơ hội
guest	khách
meaning	ý nghĩa
note	chú ý / ghi chú
photograph	bức ảnh
skill	kỹ năng
benefit	lợi ích / có lợi
rent	thuê
flight	chuyến bay
president	chủ tịch
airport	sân bay
accept	chấp nhận
january	tháng Một
improve	cải thiện
february	tháng Hai
allow	cho phép
support	hỗ trợ / ủng hộ
bring	mang
friday	thứ Sáu
become	trở nên
policy	chính sách
convenient	tiện lợi
museum	bảo tàng
december	tháng Mười Hai
tour	chuyến tham quan / du lịch
sure	chắc chắn / đảm bảo
choose	chọn
environment	môi trường
win	chiến thắng
november	tháng Mười Một
clean	sạch / làm sạch
buy	mua
between	giữa
park	công viên
bank	ngân hàng
different	khác
look forward	trông đợi
space	không gian / chỗ
build	xây dựng
in order to	để (làm gì đó)
electronic	điện tử
saturday	thứ Bảy
country	đất nước
personal	cá nhân
reduce	giảm
money	tiền
create	tạo ra
final	cuối cùng
introduce	giới thiệu
percent	phần trăm
expand	mở rộng
worker	công nhân / nhân viên
future	tương lai
again	một lần nữa / lại
serve	phục vụ
move	di chuyển / di dời
TRUE	đúng / thật sự
family	gia đình
past	qua / quá khứ
professional	chuyên nghiệp / người chuyên nghiệp
low	thấp
parking	đỗ xe
show	cho thấy
early	sớm
enjoy	tận hưởng / thích
print	in
although	mặc dù
today	hôm nay
seminar	hội thảo
document	tài liệu
regular	thường xuyên / thường
place	nơi / chỗ
safe	an toàn
soon	sớm
children	trẻ em
back	lại / trở lại
school	trường học
think	nghĩ
invest	đầu tư
limit	giới hạn
house	nhà
over	hơn
care	chăm sóc / quan tâm
minute	phút
keep	giữ
sales	doanh thu
since	từ khi
compete	cạnh tranh
total	tổng cộng
near	gần
produce	sản xuất / tạo ra
around	xung quanh / khoảng
close	đóng
bill	hóa đơn
attach	đính kèm
prepare	chuẩn bị
software	phần mềm
human	người
encourage	khuyến khích
hear	nghe
decide	quyết định (v)
join	gia nhập
there	ở đó
select	chọn
history	lịch sử
summer	mùa hè
stay	ở
check	kiểm tra / xem
ago	trước đây
same	cùng / giống nhau
learn	học
continue	tiếp tục
still	vẫn
telephone	điện thoại
nation	quốc gia
arrange	sắp xếp
news	tin tức
bus	xe buýt
under	dưới
page	trang
invite	mời
thursday	thứ Năm
feel	cảm thấy
message	tin nhắn
night	đêm
second	thứ hai
theater	nhà hát / rạp phim
tell	nói
old	cũ / lớn tuổi
necessary	cần thiết
amount	số lượng / khoản (tiền...)
presentation	buổi thuyến trình
library	thư viện
government	chính phủ
club	câu lạc bộ
road	đường
economy	kinh tế
way	cách
floor	tầng / sàn nhà
monthly	hàng tháng
sunday	Chủ Nhật
here	ở đây
organization	tổ chức
better	tốt hơn
shop	cửa hàng
shopping	mua sắm
level	mức độ / cấp độ
excellent	tuyệt vời
vehicle	xe
idea	ý tưởng
less	ít hơn
later	sau đó / trễ hơn
always	luôn luôn
machine	máy
describe	mô tả
morning	buổi sáng
immediately	ngay lập tức
install	lắp đặt / cài đặt
live	sống
enter	đi vào / đưa vào
without	không có
train	xe lửa
film	phim
coupon	phiếu giảm giá
size	kích thước / kích cỡ
accounting	kế toán
meal	bữa ăn
try	cố gắng / thử
cancel	hủy
drive	lái xe
vacation	kỳ nghỉ
complain	phàn nàn
reason	lí do
gift	quà tặng
sign	ký
spend	chi tiêu / dành (thời gian)
speak	nói / phát biểu
factory	nhà máy
welcome	chào đón
season	mùa
top	hàng đầu / trên cùng
appointment	cuộc hẹn
run	chạy
music	âm nhạc
air	không khí / hàng không
wednesday	thứ Tư
quickly	nhanh chóng
station	trạm / đài
attract	thu hút
weekend	cuối tuần
like	giống
well	tốt
activity	hoạt động
organize	tổ chức / sắp xếp
look for	tìm kiếm
tuesday	thứ Ba
then	sau đó
might	có thể
explain	giải thích
visitor	khách / du khách
display	trưng bày
believe	tin
delay	trì hoãn
wide	rộng
paper	giấy
strong	mạnh
test	kiểm tra
web	mạng
desk	cái bàn
life	cuộc sống / cuộc đời
leave	rời đi / rời khỏi
comment	lời bình
teach	dạy
book	đặt (phòng, vé...)
course	khóa học
lost	mất
late	trễ
decision	quyết định (n)
retire	về hưu
festival	lễ hội
tourist	khách du lịch
drink	uống / đồ uống
party	bữa tiệc
relations	quan hệ
America	nước Mỹ
someone	ai đó
garden	vườn
volunteer	người tình nguyện
person	người
responsible	chịu trách nhiệm
sport	thể thao
hospital	bệnh viện
happen	xảy ra
wish	muốn
down	xuống
too	quá
million	triệu
camera	máy ảnh / máy quay phim
Asia	châu Á
often	thường xuyên
answer	trả lời
demand	nhu cầu
put	đặt / để
happy	vui
front	trước
movie	bộ phim
seat	chỗ ngồi
protect	bảo vệ
difficult	khó khăn
talk	nói chuyện
kitchen	nhà bếp
lunch	bữa trưa
maintain	duy trì / bảo trì
easy	dễ dàng
away	xa
dinner	bữa tối
television / TV	truyền hình / tivi
wait	chờ
rise	tăng
avoid	tránh
understand	hiểu
color	màu sắc
deadline	hạn chót
goal	mục tiêu
post	đăng
contain	chứa đựng
agree	đồng ý
finish	hoàn thành
enough	đủ
newspaper	báo
look	nhìn
simple	đơn giản
performance	buổi biểu diễn
expensive	đắt tiền
afternoon	buổi chiều
menu	thực đơn
grow	gia tăng / phát triển
together	cùng / cùng nhau
coffee	cà phê
short	ngắn
branch	chi nhánh
real	thực sự
famous	nổi tiếng
daily	hàng ngày
weather	thời tiết
everyone	mọi người
advice	lời khuyên
friend	người bạn
friendly	thân thiện
big	lớn
never	không bao giờ
box	hộp
swimming pool	hồ bơi
outside	bên ngoài
salary	tiền lương
responsibility	trách nhiệm
fast	nhanh
anyone	bất kỳ ai
carefully	cẩn thận
style	phong cách
remind	nhắc nhở
ability	khả năng
adult	người lớn
cook	nấn ăn
save	tiết kiệm
a lot of	nhiều
clear	rõ ràng
game	trò chơi
graduate	tốt nghiệp
share	chia sẻ
walk	đi bộ
beautiful	đẹp
hold	giữ
yesterday	hôm qua
knowledge	kiến thức
table	cái bàn
picture	bức ảnh
holiday	kỳ nghỉ / lỳ lễ
culture	văn hóa
half	nửa
correct	đúng / chỉnh sửa
paint	sơn
usually	thường xuyên
last	cuối cùng
error	lỗi
comfortable	thoải mái
wedding	đám cưới
traveler	hành khách
printer	máy in
ready	sẵn sàng
everything	mọi thứ
clothing	quần áo
fashion	thời trang
topic	chủ đề
exercise	tập (thể dục)
sorry	xin lỗi / tiếc
eat	ăn
third	thứ ba / một phần ba
door	cửa
gym	phòng tập thể dục
wear	mặc / mang
young	trẻ
perfect	hoàn hảo
electricity	điện
evening	buổi tối
things	thứ / điều
men	đàn ông
stop	dừng / điểm dừng
breakfast	bữa sáng
reply	trả lời
cut	cắt / cắt giảm
step	bước
weekly	hàng tuần
suitable	phù hợp
search	tìm kiếm
play	chơi
right	đúng
dollar	đô la
opinion	ý kiến
seem	có vẻ như
cooperation	sự hợp tác
example	ví dụ
band	ban nhạc
resort	khu nghỉ mát
age	tuổi
on time	đúng giờ
little	ít
traffic	giao thông
key	chìa khóa / then chốt
prize	giải thưởng
woman	phụ nữ
mobile	di động
heavy	nặng / lớn
tomorrow	ngày mai
busy	bận rộn
bag	túi / túi xách
face	mặt / đối mặt
white	màu trắng
blue	xanh dương
advise	khuyên / thông báo
story	câu chuyện
useful	hữu ích
black	màu đen
river	con sông
depend	phụ thuộc
compare	so sánh
lake	hồ
wine	rượu vang
mistake	lỗi lầm / nhầm lẫn
farm	nông trại
mean	có nghĩa
hand	tay
brown	màu nâu
flower	hoa
image	hình ảnh
inside	bên trong
swimming	bơi
wash	giặt / rửa
hard	chăm chỉ
doctor	bác sĩ
discussion	buổi thảo luận
modern	hiện đại
action	hành động
mountain	ngọn núi
perform	biểu diễn
vegetables	rau
beside	bên cạnh
cake	bánh
fly	bay
winter	mùa đông
remember	nhớ
red	màu đỏ
behind	phía sau
boat	con thuyền
uniform	đồng phục
chair	ghế
automatic	tự động
congratulations	chúc mừng
watch	xem
way	đường
bed	cái giường
light	ánh sáng / đèn
foreign	nước ngoài
confident	tự tin
noon	trưa
password	mật khẩu
window	cửa sổ
United States	Mỹ
hot	nóng
fun	vui
teacher	giáo viên
himself	chính anh ấy / tự anh ấy
fan	người hâm mộ
beach	bãi biển
forget	quên
calendar	lịch
speed	tốc độ
study	học
cream	kem
body	cơ thể / thân
shoe	giày
fruit	trái cây
love	yêu thích / yêu thương
plane	máy bay
animal	động vật / con vật
parent	cha mẹ
cheap	rẻ
drop	giảm / rơi
trust	tin tưởng
wall	bức tường
green	xanh
back	phía sau
dry	khô
accident	tai nạn
sound	âm thanh
spring	mùa xuân
mind	tâm trí
tea	trà
truck	xe tải
far	xa
wish	chúc
island	hòn đảo
exit	lối ra
break	làm vỡ / phá vỡ
billion	một tỷ
stand	đứng
refrigerator	tủ lạnh
bike	xe đạp
fire	vụ cháy / chữa cháy
bedroom	phòng ngủ
fine	tốt
hello	chào
clothes	quần áo
hundred	một trăm
wrong	sai
Mrs.	bà
bad	xấu / tồi tệ
eye	mắt
cheese	phô mai
bicycle	xe đạp
star	ngôi sao
hard	khó
map	bản đồ
hair	tóc
cell phone	điện thoại di động
sea	biển
shirt	áo sơ mi
carry	mang / mang theo
twelve	mười hai
middle	giữa
sometimes	đôi khi
bathroom	phòng tắm
warm	ấm
nothing	không cái gì
lesson	bài học
actor	diễn viên
practice	luyện tập
rain	mưa
heart	trái tim
sit	ngồi
myself	chính tôi
miss	cô
thousand	một nghìn
too	cũng
rice	gạo
ourselves	chính chúng tôi
maximum	tối đa
kid	trẻ em
voice	giọng nói
quiet	yên tĩnh
apple	quả táo
turn off	tắt
alone	chỉ riêng / một mình
sun	mặt trời
listen	nghe
draw	vẽ
sick	bị bệnh
police	cảnh sát
anytime	bất kỳ lúc nào
zoo	sở thú
toy	đồ chơi
dream	ước mơ
T-shirt	áo thun
dish	đĩa
ship	thuyền
board	bảng
post office	bưu điện
kind	tử tế
let's	hãy
waste	lãng phí
tour guide	hướng dẫn viên du lịch
present	món quà
soft	mềm / nhẹ
press	ấn nút
miss	nhớ
right	bên phải
glass	cái ly
offer	cung cấp / đem lại
available	có
item	món hàng / món đồ
recent	gần đây / vừa rồi
local	địa phương
position	vị trí
sales	bán hàng
discount	giảm giá
advertisement	mẫu quảng cáo
indicate	chỉ ra
purpose	mục đích
finance	tài chính
line	dòng (sản phẩm, chữ)
interested	quan tâm
reserve	đặt (phòng, bàn...)
location	địa điểm
detail	chi tiết / nêu chi tiết
public	công chúng / công cộng
community	cộng đồng
market	thị trường / chợ
payment	thanh toán / tiền thanh toán
operate	hoạt động / vận hành
likely	có thể
recommend	đề nghị
industry	ngành
survey	khảo sát
facility	cơ sở
annual	hàng năm
promote	quảng bá / thúc đẩy
even	thậm chí
access	tiếp cận / truy cập
application	đơn xin
manufacture	sản xuất
due to	do
award	giải thưởng
replace	thay thế
possible	có thể
package	gói hàng / gói dịch vụ
several	một vài
session	buổi
material	vật liệu / tài liệu
resource	nguồn (lực, tài liệu...)
once	một khi / một lần
rate	giá / đánh giá
security	an ninh / an toàn
through	qua / thông qua
based	dựa trên / đặt
locate	đặt
exhibit	triển lãm
those	những người / những cái
previous	trước đây
take	tốn (thời gian)
propose	đề xuất
human resources	nhân sự
respond	trả lời / phản hồi
owner	người chủ
memo	thông báo
appreciate	cảm kích
compete	cạnh tranh
already	rồi
need	nhu cầu
mail	thư (bưu điện)
resident	người dân
suggest	đề xuất
enclose	đính kèm
representative	người đại diện
least	ít nhất
workshop	hội thảo
firm	công ty
employ	tuyển dụng
show	buổi diễn / triển lãm / chương trình
refund	tiền hoàn lại
process	quy trình
résumé	sơ yếu lý lịch
transport	vận chuyển
supplies	vật dụng
assistant	trợ lý
damage	thiệt hại
conduct	tiến hành
candidate	ứng cử viên
directly	trực tiếp
since	bởi vì
regarding	về (=about)
original	ban đầu
experience	trải nghiệm / trải qua
production	việc sản xuất / sản lượng
assist	hỗ trợ
applicant	người nộp đơn
upcoming	sắp diễn ra
fill out / fill in	điền
popular	phổ biến
place	đặt
renovate	tân trang
consulting	việc tư vấn
among	giữa
warranty	bảo hành
fund	quỹ
update	cập nhật
option	sự lựa chọn
present	trình bày / xuất trình / trao
profit	lợi nhuận
further	thêm
apartment	căn hộ
insurance	bảo hiểm
such as	như là
over	trong vòng
prefer	ưa thích hơn
instruction	sự hướng dẫn
career	sự nghiệp
ensure	đảm bảo
feature (v)	có / bao gồm
effective	hiệu quả
type	loại
supply	cung cấp
renew	gia hạn
airline	hãng hàng không
board	ban
whether	liệu... hay không / bất kể
potential	có tiềm năng
consumer	người tiêu dùng
head	người đứng đầu
meet	đáp ứng
period	khoản thời gian
condition	điều kiện
concern	sự lo lắng
efficient	hiệu quả
advance	trước
agency	công ty
budget	ngân sách
contribute	đóng góp
as well as	cũng như
energy	năng lượng
depart	khởi hành
issue	vấn đề
below	bên dưới
variety	sự đa dạng
subscription	việc đặt báo, tạp chí...
model	mẫu sản phẩm
hall	hội trường
supervisor	người giám sát
remain	vẫn còn / vẫn luôn
estimate	ước tính
approve	chấp thuận
sample	mẫu / mẫu thử
therefore	vì vậy
property	bất động sản / nhà / đất
cause	gây ra
individual	cá nhân
as soon as	ngay khi
extra	thêm
along	dọc theo
passenger	hành khách
distribute	phân phối / phân phát
probably	có thể
throughout	xuyên suốt / khắp
CEO	tổng giám đốc
apply	áp dụng
yet	vẫn chưa
region	vùng
specific	cụ thể
set	thiết lập / cài đặt / sắp đặt
field	lĩnh vực
pick up	lấy / đón
lead	dẫn / dẫn dắt
satisfy	thỏa mãn
maintenance	việc bảo trì
instead	thay vì / thay vì vậy
degree	tấm bằng
strategy	chiến lược
notify	thông báo cho
kind	loại
receipt	biên nhận
study	nghiên cứu
performance	hiệu suất
leave	để lại / để cho
sign up	đăng ký
upon	vào lúc
personnel	nhân sự
exchange	đổi
furniture	đồ nội thất
concert	buổi hòa nhạc
though	mặc dù
take place	diễn ra
significant	đáng kể
expenses	chi phí
retail	bán lẻ
process	xử lý
latest	mới nhất
value	giá trị
either	một trong hai
solution	giải pháp
method	phương pháp
permit	cho phép / giấy phép
case	trường hợp
technical	kỹ thuật
record	hồ sơ / ghi nhận
apologize	xin lỗi
standard	tiêu chuẩn
seek	tìm kiếm
file	tập tin / hồ sơ
raise	tăng / quyên góp
unfortunately	không may
despite	mặc cho
goods	hàng hóa
law	luật
guide	hướng dẫn
feature (n)	đặc tính / tính năng
campaign	chiến dịch
lecture	bài diễn thuyết
issue	số (tạp chí, báo...)
frequent	thường xuyên
temporary	tạm thời
attention	sự chú ý
leader	người lãnh đạo / người dẫn đầu
store	cất trữ
handle	xử lý
related	liên quan
ceremony	buổi lễ
direction	sự hướng dẫn / đường đi
data	dữ liệu
tax	thuế
collect	thu thập
celebrate	ăn mừng
laboratory	phòng thí nghiệm
proper	đúng cách / phù hợp
guarantee	đảm bảo
get	trở nên / được
committee	ủy ban
code	mã
regulation	quy định
impress	gây ấn tượng
as	như / vì / khi
valid	có hiệu lực / hợp lệ
complimentary	miễn phí
artist	nghệ sĩ
quarter	quý (3 tháng)
recruit	tuyển dụng
above	trên
invitation	thư mời
donation	sự đóng góp
site	địa điểm / nơi
launch	tung ra
catalog	danh mục (sản phẩm,...)
division	bộ phận
choice	sự lựa chọn
power	điện / năng lượng
inspection	việc kiểm tra
term	điều khoản
extend	kéo dài
speaker	người diễn thuyết
excited	hào hứng
appear	xuất hiện
partner	đối tác
analyze	phân tích
release	tung ra
fair	hội chợ
prior	trước
effort	nỗ lực
defective	bị lỗi
affect	tác động đến
café / cafeteria	quán ăn uống
express	bày tỏ
device	thiết bị
certificate	giấy chứng nhận
obtain	có được / lấy được
evaluate	đánh giá
range	nhiều loại / sự đa dạng
ever	từ trước đến nay / từng
eligible	đủ điều kiện
across	khắp / bên kia
offer	đề nghị
relocate	dời địa điểm
leading	dẫn đầu
council	hội đồng
inquire	hỏi
recycle	tái chế
determine	xác định
chef	đầu bếp trưởng
demonstrate	chứng tỏ / trình bày
issue	cấp / đưa ra
cost (v)	tốn phí
invoice	hóa đơn
gallery	phòng trưng bày
procedure	quy trình
in person	trực tiếp
check	séc
satisfaction	sự hài lòng
fresh	tươi
approximately	khoảng chừng
found	thành lập
growth	sự tăng trưởng
language	ngôn ngữ
consultant	người tư vấn
technician	kỹ thuật viên
competition	cuộc thi
vice	phó
unless	trừ khi
unique	độc đáo
entrance	lối vào
expert	chuyên gia
initial	ban đầu
almost	hầu như
headquarters	trụ sở
trend	xu hướng
agreement	thỏa thuận
itinerary	lịch trình
average	trung bình
against	chống lại / đối với
upgrade	nâng cấp
except	ngoại trừ
brochure	tờ rơi
speech	bài diễn thuyết
warehouse	nhà kho
outdoor	ngoài trời
effect	tác động / hiệu lực
innovative	đổi mới
full-time	toàn thời gian
downtown	trung tâm thành phố
over	trên
duty	nhiệm vụ
connect	kết nối
opening	vị trí trống
agent	người đại diện
inquiry	câu hỏi
recognize	công nhận
no longer	không còn nữa
minimum	tối thiểu
situation	tình huống
reach	đạt được
management	ban quản lý
host	tổ chức
merchandise	hàng hóa
destination	điểm đến
task	nhiệm vụ
fail	thất bại / không làm
manual	sách hướng dẫn
appliance	thiết bị
transfer	chuyển
implement	ban hành
extensive	trên phạm vi rộng
take advantage of	tận dụng
merger	vụ sáp nhập
leadership	sự lãnh đạo
source	nguồn
beverage	thức uống
anniversary	kỷ niệm
brief	ngắn gọn
shipment	lô hàng
used to	đã từng
quite	khá
feedback	sự phản hồi
revenue	doanh thu
promote	thăng chức
exclusive	riêng / đặc biệt
plant	nhà máy
alternative	thay thế
usual	bình thường / thông thường
due	tới hạn / phải trả
overseas	ở nước ngoài
cash	tiền mặt
dish	món ăn
selection	tập hợp (sản phẩm...)
industrial	công nghiệp
thorough	kỹ lưỡng
accommodation	chỗ ở
instructor	người hướng dẫn
colleague	đồng nghiệp
collection	bộ sưu tập
similar	giống / tương tự
taste	mùi vị / nếm mùi vị
honor	vinh danh / vinh dự
route	tuyến đường
authorize	ủy quyền
real estate	bất động sản
deal with	giải quyết / làm việc với
address	giải quyết
mayor	thị trưởng
dining	ăn uống
audience	khán giả
fix	sửa chữa
exact	chính xác
extremely	cực kỳ
donate	đóng góp
challenge	thách thức
specify	nêu cụ thể
tourism	du lịch
accommodate	đáp ứng / chứa được
remove	loại bỏ
guideline	hướng dẫn
decade	thập kỷ
patient	bệnh nhân
check in	nhận phòng / làm thủ tục
prevent	ngăn
view	xem
assign	chỉ định
control	kiểm soát / điều khiển
establish	thành lập / thiết lập
advantage	lợi thế
helpful	hữu ích
decrease	giảm
expire	hết hạn
occur	xảy ra
summary	bảng tóm tắt
concerning	về (=about)
yourself	chính bạn
traditional	truyền thống
identification	chứng minh thư
affordable	có giá phải chăng
specialize in	chuyên về
familiar	quen thuộc
photography	nhiếp ảnh / việc chụp ảnh
reputation	danh tiếng
otherwise	khác / ngược lại
ingredient	thành phần
capacity	sức chứa / công suất
cover letter	thư xin việc
own	sở hữu
double	gấp đôi
right	quyền
predict	dự đoán
stock	hàng hóa
talk	bài diễn thuyết
fill	làm đầy
enhance	tăng cường
subscriber	người đặt báo, tạp chí...
bonus	tiền thưởng
accompany	đi kèm
negotiate	đàm phán
shuttle	xe trung chuyển
ahead	trước
accurate	chính xác
relationship	mối quan hệ
present	có mặt
board	lên (tàu, xe buýt...)
site	trang web
engineer	kỹ sư
vote	bầu chọn
cause	nguyên nhân
completely	hoàn toàn
recall	thu hồi
agricultural	nông nghiệp
license	giấy phép
postpone	trì hoãn
normal	bình thường
assess	đánh giá
analyst	nhà phân tích
ideal	lý tưởng
promptly	ngay lập tức / nhanh chóng
achieve	đạt được
reschedule	dời lịch
productivity	năng suất
reasonable	hợp lí
fall	rơi / giảm
intern	thực tập sinh
exceed	vượt quá
outstanding	tuyệt vời / xuất sắc
next to	cạnh
twice	hai lần
reliable	đáng tin cậy
ground	mặt đất
adjust	điều chỉnh
examine	kiểm tra
part-time	bán thời gian
equip	trang bị
priority	ưu tiên
resolve	giải quyết
creative	sáng tạo
screen	màn hình
figure	con số
decline	giảm
temperature	nhiệt độ
voucher	phiếu giảm giá
assemble	lắp ráp / tập hợp
gather	thu thập / tập hợp
recipient	người nhận
rarely	hiếm khi
acquire	mua lại / có được
willing	sẵn lòng
moreover	hơn nữa
click	nhấp chuột
flexible	linh hoạt
outline	vạch ra
in spite of	mặc cho
baggage	hành lý
lobby	tiền sảnh
land	đất
shift	ca làm việc
whereas	trong khi
neither	không cái nào
independent	độc lập
highway	đường cao tốc
comprehensive	toàn diện
dessert	món tráng miệng
signature	chữ ký
target	mục tiêu / nhắm đến
function	chức năng
solve	giải quyết
plant	cái cây
disappoint	gây thất vọng
sign	bảng hiệu / dấu hiệu
loyal	trung thành
furthermore	hơn nữa
luggage	hành lý
mostly	hầu hết
delicious	ngon
appoint	bổ nhiệm
committed	tận tâm
trash	rác
interesting	thú vị
generous	hào phóng
nevertheless	tuy nhiên
hardly	hầu như không
broad	rộng
subject	chủ đề
sincerely	chân thành
word	từ
paragraph	đoạn văn
corporation	tập đoàn
per	mỗi
state	nói / chỉ ra
dr.	tiến sĩ / bác sĩ
credit	tín dụng
executive	điều hành / người điều hành
medical	y tế
own	chính (ai đó)
town	thị trấn / thành phố
communication	giao tiếp / liên lạc
fitness	thể hình / thể dục
offer	khuyến mãi
education	giáo dục
oil	dầu
editor	biên tập viên
brand	thương hiệu
intend	dự định
focus	tập trung
point	điểm
10% off	giảm giá 10%
various	khác nhau
infer	suy ra
europe	châu âu
section	phần
association	hiệp hội
such	như vậy
reference	sự tham khảo
author	tác giả
south	phía nam
actually	thực ra / thực sự
series	xê-ri
aware of	biết / nhận thức
east	phía đông
recipe	công thức nấu ăn
chief	tổng / trưởng
matter	vấn đề
network	mạng lưới
north	phía bắc
natural	tự nhiên / thiên nhiên
loan	khoản vay
commercial	thương mại
rate	tỉ lệ
get	đi
battery	cục pin
grant	tiền trợ cấp / cấp
chance	cơ hội
pass	thẻ
status	trạng thái
newsletter	thư tin tức
society	hiệp hội
perform	thực hiện
cover	bao gồm
west	phía tây
internship	đợt thực tập
official	quan chức
through	đến
district	khu vực
via	bằng
ID	chứng minh thư
gas	ga / xăng
digital	kỹ thuật số
toward	hướng về phía / đối với
sponsor	nhà tài trợ
appropriate	phù hợp
as well	cũng
side	phía / bên
track	theo dõi
entertainment	giải trí
imply	ngụ ý
revise	chỉnh sửa
set	bộ
qualified	đủ trình độ
chemical	hóa chất
those	đó
plus	cộng thêm
race	cuộc đua
label	nhãn / nhãn hiệu
others	những người/cái khác
qualification	trình độ / khả năng chuyên môn
painting	bức tranh / việc vẽ tranh
contest	cuộc thi
deal	thỏa thuận / khuyến mãi
should	nếu (≈if)
forward	về phía trước / chuyển tiếp
fuel	nhiên liệu
administrative	hành chính
charity	hội từ thiện
pharmaceutical	dược
restore	phục hồi
content	nội dung
leave	nghỉ phép
break	thời gian nghỉ
dedicated	tận tâm
filter	lọc / đồ lọc
auto	ô tô
ad	quảng cáo
turn	chuyển
fact	sự thật / sự việc
admission	việc vào cửa
proud	tự hào
in fact	thật vậy / thật ra
pass	đi qua / vượt qua
talent	tài năng
express	tốc hành
greatly	rất nhiều
expertise	chuyên môn
engineering	kỹ thuật
compensation	tiền đền bù / lương thưởng
title	tựa đề / tựa sách
piece	mẩu / mẩu đồ
tool	công cụ
rather than	thay vì
catering	việc cung cấp suất ăn
convention	hội nghị
deposit	tiền đặt cọc
mark	đánh dấu
mall	trung tâm mua sắm
loss	sự mất mát / thua lỗ
certainly	chắc chắn
reception	buổi đón tiếp / buổi tiệc
stock	cổ phiếu
ones	những cái / những người
automobile	ô tô
reimburse	hoàn tiền
numerous	nhiều
else	khác
background	nền tảng / lý lịch
separate	tách rời
common	thông thường
primary	chủ yếu / chính
view	góc nhìn
formal	trịnh trọng / chính thức
promotion	khuyến mãi
valuable	quý giá
peak	cao điểm / đỉnh điểm
lawn	bãi cỏ
rapidly	nhanh chóng
generate	tạo ra
approach	tiếp cận / đến gần
reward	phần thưởng / thưởng
assignment	nhiệm vụ
in charge	chịu trách nhiệm
flyer	tờ rơi
administration	việc quản trị
favorite	ưa thích nhất
realize	nhận ra
architecture	kiến trúc
aim	mục tiêu / nhắm đến
recover	phục hồi
secretary	thư ký
distance	khoảng cách
century	thế kỷ
envelope	bì thư
quantity	số lượng
anticipate	trông đợi
play	vở kịch
grand opening	buổi khai trương
version	phiên bản
plastic	nhựa
comply	tuân thủ
rule	quy định
impact	tác động
cable	dây cáp
technique	kỹ thuật
confidential	bí mật
work	hoạt động
inventory	hàng hóa / kiểm kê hàng
on behalf of	thay mặt cho
match	tương ứng / phù hợp với
scholarship	học bổng
assure	đảm bảo
poor	tệ
as long as	miễn là
whenever	bất kỳ khi nào
nearby	ở gần đó
shareholder	cổ đông
risk	rủi ro
considerable	đáng kể
balance	số dư / tiền còn lại
meter	mét
consult	hỏi ý kiến / tham khảo
huge	khổng lồ
artwork	tác phẩm nghệ thuật
patron	khách
durable	bền
vacancy	vị trí trống / chỗ trống
stop by / drop by	ghé đến
emergency	việc khẩn cấp
factor	nhân tố
retain	giữ lại
publication	ấn phẩm
earlier	trước đó
packaging	bao bì
interest	lãi
well-known	nổi tiếng
relatively	tương đối
carpet	tấm thảm
rely on	phụ thuộc / tin cậy
run	điều hành
exceptional	tuyệt vời
slightly	một ít / nhỏ
occasion	dịp
critic	nhà phê bình
elevator	thang máy
measure	đo lường
highlight	làm nổi bật
conclude	kết luận
direct	chuyển đến / hướng đến
light	nhẹ
record	thu âm / thu hình
wildlife	động vật hoang dã
lack	sự thiếu
regret	tiếc
proceed	tiến hành / tiến đến
booth	gian hàng / buồng
steadily	đều
spacious	rộng rãi
restrict	giới hạn
fall	mùa thu
well	rất / rất nhiều
grocery	thực phẩm
commitment	sự cam kết / tậm tân
circumstance	hoàn cảnh
emphasize	nhấn mạnh
commute	đi đến chỗ làm
carry out	tiến hành
practice	cách thức / thói quen
regardless of	bất kể
lease	thuê / hợp đồng thuê
consistently	luôn luôn / đều đặn
population	dân số
qualify	đủ điều kiện
forum	diễn đàn
donor	người đóng góp
authority	người có thẩm quyền / quyền hành
oversee	giám sát
each other	nhau / lẫn nhau
onto	lên trên
golf	môn đánh gôn
substantial	đáng kể
sufficient	đủ
missing	thiếu / bị mất
writer	tác giả / nhà văn
worldwide	khắp thế giới
weight	trọng lượng
shortly	một thời gian ngắn / sớm
refreshments	đồ ăn, đồ uống nhẹ
pressure	áp lực
line	đường dây
measure	biện pháp
eager	háo hức
office supplies	văn phòng phẩm
entry	việc đi vào
waste	rác thải
rather	khá
pay	lương
transit	vận chuyển
proof	bằng chứng
nor	cũng không
glad	vui
banquet	đại tiệc
adequate	đủ / phù hợp
essential	cần thiết
equal	bằng / bằng nhau
cautious	cẩn thận
fulfill	đáp ứng
repeat	lặp lại
urgent	khẩn cấp
accordingly	theo đó / phù hợp
lawyer	luật sư
subject to	chịu
transaction	giao dịch
withdraw	rút
conflict	mâu thuẫn
collaborate	hợp tác
disruption	sự gián đoạn
cabinet	cái tủ
by the time	tính đến lúc
necessarily	nhất thiết
acquaintance	người quen
break down	bị hư
absent	vắng mặt
lately	gần đây
inc.	tập đoàn
corporate	doanh nghiệp
senior	cấp cao
major	lớn
press	báo chí
media	truyền thông
science	khoa học
regards	kính chúc
college	cao đẳng
involve	bao gồm
official	chính thức
professor	giáo sư
avenue	đại lộ
entire	toàn bộ
line	tuyến
work	tác phẩm
officer	giám đốc / cán bộ
certain	nhất định
global	toàn cầu
institute	viện
venue	địa điểm
private	riêng tư / cá nhân
last	kéo dài
organic	hữu cơ
state	tiểu bang
suite	dãy phòng
graphic	đồ họa / hình ảnh
journal	tạp chí
associate	người cộng tác
general	thường / chung
role	vai trò / vai diễn
press release	thông cáo báo chí
term	hạn / thời hạn
advanced	cao cấp / tiên tiến
basic	cơ bản
particular	đặc biệt
overall	nói chung / toàn bộ
coordinator	người điều phối
nature	thiên nhiên
single	chỉ một cái / từng cái một
claim	đòi (bồi thường,...)
positive	tích cực
get	khiến cho / làm cho
surprise	gây ngạc nhiên
right	ngay
legal	pháp lý
on-site	tại chỗ
hesitate	ngại
former	trước đây
edition	phiên bản
heat	sửi nóng / sức nóng
steel	thép
treatment	việc chăm sóc / điều trị
foundation	tổ chức
relevant	thích hợp / liên quan
faculty	ban giảng viên
form	dạng / loại
interior	nội thất
county	quận
citizen	công dân
gain	có được
glass	kính / thủy tinh
live	trực tiếp
cover	nói đến / bao gồm
existing	hiện tại
vendor	người bán
renowned	nổi tiếng
discover	phát hiện / khám phá
reach	liên lạc
whole	toàn bộ
salt	muối
academic	học thuật
thanks to	nhờ vào
wireless	không dây
basis	cơ sở
appeal	hấp dẫn
uk	Anh Quốc
tip	mẹo
database	cơ sở dữ liệu
lounge	phòng thư giãn
accessory	phụ kiện
complex	tổ hợp
trade	thương mại
director	đạo diễn
labor	nhân công / lao động
questionnaire	bảng câu hỏi
terminal	nhà ga
neighborhood	khu vực
permanent	lâu dài / cố định
respect	tôn trọng
aid	hỗ trợ
scale	quy mô
lot	bãi / lô đất
class	hạng / loại
wonderful	tuyệt vời
valley	thung lũng
social	xã hội
athlete	vận động viên
africa	châu Phi
general	tổng
production	kịch / phim / chương trình
progress	sự tiến triển
chain	chuỗi
landscaping	cảnh quan / thiết kế cảnh quan
combine	kết hợp
extension	số máy lẻ
off	khỏi / ra khỏi
strict	nghiêm ngặt
plan	gói (dịch vụ...)
solar	mặt trời
inn	khách sạn nhỏ
costume	trang phục
attempt	cố gắng / thử
finalize	hoàn thành
meter	đồng hồ đo
volume	khối lượng / số lượng
worth	giá trị / đáng
supposed	được dự định
fit	phù hợp với
enterprise	doanh nghiệp
novel	tiểu thuyết
premium	cao cấp
memorandum	thông báo
domestic	trong nước
clerk	nhân viên
institution	tổ chức
wing	cánh
thus	vì vậy
personally	đích thân / bản thân
manner	cách
residential	nhà ở
unit	căn hộ
square	vuông
statement	bảng sao kê
concern	liên quan đến
hand	nộp / đưa
state-of-the-art	hiện đại
stay	tiếp tục / luôn luôn
address	diễn thuyết / nói về
base	lượng (khách hàng...)
commission	ủy ban
surround	bao quanh / xoay quanh
verify	xác minh
engine	động cơ
possibility	khả năng
panel	tấm
then	vậy thì
savings	tiền tiết kiệm
preview	xem trước
kit	bộ
undergo	trải qua
given	xét
serious	nghiêm trọng / nghiêm túc
physical	thể chất
multiple	nhiều
athletic	thể thao / điền kinh
gold	vàng
import	nhập khẩu
fundraising	việc gây quỹ
spokesperson	người phát ngôn
income	thu nhập
eco	môi trường / sinh thái
junior	cấp thấp
sector	lĩnh vực
aspect	khía cạnh
minor	nhỏ
look to	muốn
programming	lập trình
disease	căn bệnh
monitor	giám sát
with/in regard to	về (= about)
unit	sản phẩm
rest	phần còn lại
model	mô hình
apparel	quần áo
amazing	tuyệt vời
quote	báo giá
in case	phòng khi / trong trường hợp
timely	kịp thời
belongings	đồ đạc
now that	bởi vì bây giờ
regard	đánh giá
grateful	biết ơn
utilize	sử dụng
payroll	tiền lương
occasionally	thỉnh thoảng
mutually	chung
remodel	sửa đổi
wonder	muốn biết
resign	từ chức
mechanic	thợ máy
orientation	việc định hướng
strength	điểm mạnh / sức mạnh
injury	chấn thương
consist	bao gồm
sightseeing	việc ngắm cảnh
divide	chia
incorporate	kết hợp
enthusiastic	nhiệt tình
ongoing	đang diễn ra
reminder	thư nhắc nhở
provided that	miễn là
prohibit	cấm
intention	ý định
alike	như nhau
on the other hand	mặt khác
absent	vắng mặt
shortage	sự thiếu
characteristic	đặc điểm
sensitive	nhạy cảm / nhạy
amateur	nghiệp dư
dramatically	nhanh chóng
owing to	do
wage	tiền lương
whichever	bất kỳ cái nào
array	tập hợp
favorable	thuận lợi
alternate	thay thế
dangerous	nguy hiểm
lately	gần đây (recently)
concentrate	tập trung
precisely	chính xác
interrupt	gây gián đoạn
scenery	quang cảnh
enroll	đăng ký
elsewhere	ở nơi khác
sum	số tiền
deserve	xứng đáng
sharply	nhanh chóng
row	hàng
one another	lẫn nhau
wrap	gói
beforehand	trước
adversely	bất lợi
institute	ban hành
turn in	nộp
stadium	sân vận động
periodically	thỉnh thoảng
in touch	liên lạc
abundant	nhiều
immensely	to lớn
agenda	nội dung cuộc họp
escort	đi theo
blend	sự pha trộn
consequently	vì vậy
journey	chuyến đi
waive	bãi bỏ